X,X,X,X,X,X,X,X,X,X,X,X
X,,,,,,,,,,,X
X,,,,,,,,,,,X
X,,,,,,,,,,,X
X,,,,,,,,,,,X
X,,,,,,,,,,,X
X,,,,,,,,,,,X
X,,,X,X,X,X,X,,,,X
X,,,X,,,,X,,,,X
X,,,X,,,,X,,,,X
X,,,X,,,,X,,,,X
X,S,,X,,,,X,,E,,X
X,,,X,,,,X,,,,X
X,,,X,,,,X,,,,X
X,,,X,X,X,X,X,,,,X
X,,,,,,,,,,,X
X,,,,,,,,,,,X
X,,,,,,,,,,,X
X,,,,,,,,,,,X
X,,,,,,,,,,,X
X,,,,,,,,,,,X
X,,,,,,,,,,,X
X,,,,,,,,,,,X
X,,,,,,,,,,,X
X,X,X,X,X,X,X,X,X,X,X,X